111111111111111111111
1W0000000000000000001
111111111111111111111
WE textures/img_we.png
NO textures/img_no.png
SO textures/img_so.png
EA textures/img_ea.png

F 20,20,20
C 200,200,200
